*    *    
**L****** 
     * ***
***S *    
*  **E*   
*   * *** 
L****E  * 
*   *   * 
*   ****E 
*L**D  ** 