*oooo*oooo
*********o
ooooo*o***
***So*oooo
*oo****ooo
*ooo*o***o
*****ooo*o
*ooo*ooo*o
*ooo*****o
*****ooo**