*oooo*oooo
*********o
ooooo*o***
****o*oooo
*oo****ooo
*ooo*o***o
*****ooo*o
*ooo*ooo*o
*ooo*****o
*****ooo*S