*    *    
********* 
     * ***
***S *    
*  **E*  
*   * *** 
*****E  * 
*   *   *
*   ****E 
*****  **